*X*****XX****X*****X
*XXX*X****XX*X*X*X**
***X**X*XX***X*X**X*
XX**X**X**X*X***X**X
*X*X*X**X*X**XX**X**
***X*X*X***X*XXX**X*
*XX****X*XXX**X*X**X
***XX*X*****X****X**
XX****X*XX*X*XXX*X*X
***X*X***X**********