***XXXX*XXXXXXXXXX
XX*XXXX*XXXXXXXXXX
XX*XX********XXXXX
XX****X*XXXXXXXXXX
XXXXXXX***********
XXX*****XXXXXX*XXX
XX**XXX****XXX*XXX
XXXXXXXXXX*XXX*XXX
XXXXXXXXX**XXX*XXX
XXXXXXXXX*XXXXXXXX
XXXXXXXXX******XXX
XXXXXXXXXXXXXX****