******XXXXXXXXXXXXXX
XXXXX*XXXXXXXXXX***X
XXXXX*XXXXXXXXX**XXX
XXXXX*XXXXX*****X**X
XXXXX*XXXX**XXXXX*XX
XXXXX*XXXX*XX*****XX
XXX****XXX*X**XXXX*X
XXX*XX*****X*XXXXX*X
XX**X**XX*XX*XXX***X
X**X**XX*****X***XXX
X*X**XX**XX*XX*XXXXX
X*X*X***XXX*X**XXXXX
X*X*X*XXX*****XXXXXX
X*X*X*X***XX*XXXXXXX
X*X*X*X*XXX***XXXXXX
X*X*X*X*X***X*XXXXXX
X*X*X*X*X*XXX*XXXXXX
X*X*XXX*X*XXX*XXXXXX
X*X*X***X*XXX*XXXXXX
XXXXXXXXXXXXX*******